##########   #######
#        #   #     #
#        #   #  $  #
#        #   #     #
#        #   ###   #
#   /////#     ## ##
#////////#   ###   #
#  //////#   #     #
#  ////*/#   #     #
# ///#####   #/////#
#////#       #  ///#
#  //#####   #//// #
#   //   #   #///  #
#    #   #   #     #
######   #   #     #
# /      #   #//// #
#/+/     #   #     #
# ///////#####//// #
#//////////////////#
####################