####################
#         /////  * #
#           /////  #
#            ///// #
#             /////#
#      //////////  #
######### /////  ###
        #////////#  
        #        #  
        #       ##  
#########        ###
#                  #
#/////////    +    #
#   ////////       #
#      //////      #
#        ###########
#        #          
#   $    #          
#        #          
##########          