####################
# //////////////// #
#  /////////////   # 
#   ////////////// #
#      //////////  #
#           ########
#           #       
#           #       
#           #       
#           #       
#           ########
#//////////////////#
#//////////////////#
#////////        * #
#    //////////    #
#         ////######
#      #####    +  #
#   $  #############
#      #############
####################