####################
# //////////////// #
#  ///////////// + # 
#   ////////////// #
#      //////////  #
#         /////    #
#      //////      # 
#   ///////        #
#//////            #
#                  #
#                  #
#                  #
#                  #
#                  #
#                  #
#     ##        *  #
#      ##          #
#      #############
#        $  ########
####################