####################
# //////////////// #
#  ///////////// * # 
#   ////////////// #
#      //////////  #
#                  #
#                  # 
#                  #
#                  #
#                  #
#                  #
#                  #
#                  #
#             +    #
#                  #
#      #############
#      #############
#   $  #############
#      #############
####################